name:Test Level
comment:This a first test level !
spriteSheet:/res/images/Sprite-0001.png
background:/res/images/background-large.jpg
mapSize:40x19
tileSize:16x16
tile:0=7
tile:1=116
tile:2=12
tile:3=35
tileMap:
3311111111111113111111111111111111111111
3311111111311111111111111111111111111111
3311131111111111111111111111111111111111
1100000011111111000000000000000000001111
1100000011111111000000000000000000001111
1100000011111111000000000000000000001111
1100000000000000000000000000000000000011
1100000000000000000000000000000000000011
1100000000000000000000000000000000000011
1100000000000000000000000000000000000011
1111000111111111111111111111111111111111
1111000000000000000111111111111111111111
1100000000000000000000000000000000000011
1100000000000000000000000000000000000011
1111111111111111111111111111000111111111
1100000000000000000000000000000000000011
1100000000000000000000000000000000000011
1111111111111111111111111111111111111111
1111111111111111111111111111111111111111
end
