name:Test Level
comment:This a first test level !
spriteSheet:/res/images/Sprite-0001.png
background:/res/images/background-large.jpg
mapSize:40x19
tileSize:16x16
tile:0=0
tile:1=116
tile:2=12
tile:3=35
tile:F=3
tile:M=23
tile:P=999
tileMap:
3311111111111113111111111111111111111111
3311111111311111111111111111111111111111
3311131111111111111111111111111111111111
1100000011111111000000000000000000001111
1100000011111111000000000000000000001111
1100000011111111000000000000000000001111
1100000000000000000000000000000000000011
1100000000000000000000000000000000000011
11P0000000000000000000000000000000000011
11000000000M00000000F0000000000000000011
1111000111111111111111111111111111111111
1111000000000000000111111100000001111111
1100000000000000000000000000000000000011
110000000000M000000000000000000000000011
1111111111111111111111111111000111111111
1100000000000000000000000000000000000011
1100000000000000000000000M00000000000011
1111111111111111111111111111111111111111
1111111111111111111111111111111111111111
end
